R 1920 1080

NO ./textures/tex_no.txt
SO ./textures/tex_so.txt
WE ./textures/tex_we.txt
EA ./textures/tex_ea.txt

S ./textures/tex_sp.txt
F 220,100,0
C 225,30,0

       11111
       10001111
111111110100001
100000000100001
100011110101111
10001  10111
11111  101
       111