R 300 300

NO ./textures/wall_1.xpm
SO ./textures/wall_2.xpm
WE ./textures/purplestone.xpm
EA ./textures/bluestone.xpm

S ./textures/sprite_1.xpm
F 90,95,100
C 90,75,80

       11111
       10001111
111111110100001
10000000010S021
100011110101111
10201  10111
11111  121
       111
