R 800 600

NO ./textures/wall_1.xpm
SO ./textures/wall_2.xpm
WE ./textures/purplestone.xpm
EA ./textures/bluestone.xpm

S ./textures/tex_sp.txt
F 90,95,100
C 90,75,80

       11111
       10001111
111111110100001
10000000010S001
100011110101111
10001  10111
11111  101
       111