R 800 600

NO ./textures/tex_no.txt
SO ./textures/tex_so.txt
WE ./textures/tex_we.txt
EA ./textures/tex_ea.txt

S ./textures/tex_sp.txt
F 95,105,115
C 100,85,90

       11111
       10001111
111111110100001
10000000010S001
100011110101111
10001  10111
11111  101
       111