R 700 400

NO ./textures/purplestone.xpm
SO ./textures/bluestone.xpm
WE ./textures/wall_1.xpm
EA ./textures/wall_2.xpm

S ./textures/pillar.xpm
F 95,105,115
C 80,75,80

1111111111111111111111111111111111111111111111
1000000000000000000000000000000000000000000001
1000002000000000200000000000000000000000000001
1000000000000000000000000000000000000000000001
1000000002000000000020000000000000000000000001
1000000000000200000000000000000000000000000001
1000000000000000000000000000000000000000000001
1000002000000000000000000000000000000000000001
1000000000000000000000000000000000000000000001
101000100010001W010000001000000000000000000001
1000000000000000000000000000000000000000000001
1000000000000000000000000000000000000000000001
1000002000000000000000000000000000000000000001
1000000000000000000000000000000000000000000001
1111111111111111111111111111111111111111111111