R 800 600

NO ./textures/purplestone.xpm
SO ./textures/bluestone.xpm
WE ./textures/wall_1.xpm
EA ./textures/wall_2.xpm

S ./textures/sprite_1.xpm
F 95,105,115
C 80,75,80

111111111111111111111111111
100000000000001000000000001
100000000000001111000100001
111111011110111001000100001
100000000100000001101100001
100000000100000000000100001
111101111111000000000100001
100000000000001111000100001
100000000001000001000100001
101111111111111101111011111
101000100010001N01000000101
101010101010101111000010101
101010101010101010001010101
100010001000100010101010001
111111111111111111111111111