R 800 600

NO ./textures/tex_no.txt
SO ./textures/tex_so.txt
WE ./textures/tex_we.txt
EA ./textures/tex_ea.txt

S ./textures/tex_sp.txt
F 95,105,115
C 100,85,90

111111111111111111111111111
100000000000001000000100001
100000000000001111000000001
111111111100011001000000001
100000000000000001000000001
100000000000000000000000001
111111110000000000000000001
100000000000000010000000001
100000000001000000000000001
100000000000000000000000001
100000000000000N00000000001
111111111111111111111111111