R 800 600

NO ./textures/purplestone.xpm
SO ./textures/bluestone.xpm
WE ./textures/wall_1.xpm
EA ./textures/wall_2.xpm

S ./textures/pillar.xpm
F 95,105,115
C 80,75,80

111111111111111111111111111
100000000000000000000000001
100020000000000000000000001
100000020000000000000000001
100000000000000000000000001
100000020000020000000000001
100000000000000002000000001
100020000000000000000000001
100000000000000000000000001
101000100010001N01000000101
100000000000000000000000001
100000000000000000000000001
100000000000000000000000001
100000000000000000000000001
111111111111111111111111111